10 10
2 3
0 0 0 0 0 0 0 0 0 0 0 0
0 0 0 0 0 0
0 0 1000
0 0 0 0
0
3 0 0 0 0 0 0 0 0 1
6 0 0 0 0 0 0 0 0 4
6 0 0 0 0 0 0 0 0 4
6 0 0 0 0 0 0 0 0 4
6 0 0 0 0 0 0 0 0 4
6 0 0 0 0 0 0 0 0 4
6 0 0 0 0 0 0 0 0 4
6 0 0 0 0 0 0 0 0 4
17 2 2 2 2 2 2 2 2 18
5 5 5 5 5 5 5 5 5 5