79 42
34 3
2 3 3 3 4 9 10 14 14 1 2 6
10 5 3 20 45 2
5 5 100 
5 6 2 3
20
0 0  0  0  0  0  0  0 0 0 0 0 0 0 0  0  0  0  0  0  0  0 0 0 0 47 45 45 50 0  0  0  0  0  0 0 0 0  0  0  0  0  0  0  0  0  0 0  0 0 0  0  0  0  0  0 0 0 0  0  0  0  0  0  0  0  0  0  0  0  0  0  0 0 0 0 0 0 0 
0 0  0  0  0  0  0  0 0 0 0 0 0 0 0  0  0  0  0  0  0  0 0 0 0 48 43 43 51 0  0  0  0  0  0 0 0 0  0  0  0  0  0  0  0  0  0 0  0 0 0  0  0  0  0  0 0 0 0  0  0  0  0  0  0  0  0  0  0  0  0  0  0 0 0 0 0 0 0 
0 0  0  0  0  0  0  0 0 0 0 0 0 0 0  0  0  0  0  0  0  0 0 0 0 49 41 46 52 0  0  0  0  0  0 0 0 0  0  0  0  0  0  0  0  0  0 0  0 0 0  0  0  0  0  0 0 0 0  0  0  0  16 0  0  0  0  0  0  0  0  0  0 0 0 0 0 0 0 
3 0  0  0  0  0  0  0 0 0 0 0 0 0 0  0  0  0  0  0  0  0 0 0 0 0  32 0  0  0  0  0  0  0  0 0 0 0  0  0  0  0  0  0  0  0  0 0  0 0 0  0  0  0  0  0 0 0 0  0  0  0  0  0  0  0  0  0  0  0  0  0  0 0 0 0 0 0 0 
6 0  0  0  0  0  0  0 0 0 0 0 0 0 0  0  0  0  0  0  0  0 0 0 0 0  32 0  0  0  0  0  0  0  0 0 0 0  0  0  0  0  0  0  0  0  0 0  0 0 0  0  0  0  0  0 0 0 0  0  0  0  0  0  0  0  0  0  0  0  0  0  0 0 0 0 0 0 0 
6 0  0  0  0  0  0  0 0 0 0 0 0 0 0  0  0  0  0  0  0  0 0 0 0 0  32 0  0  0  0  0  0  0  0 0 0 0  0  0  0  0  0  0  0  0  0 0  0 0 0  0  0  0  0  0 0 0 0  0  0  0  0  0  0  0  0  0  0  0  0  0  0 0 0 0 0 0 0 
6 0  0  0  0  0  0  0 0 0 0 0 0 0 0  0  0  0  0  0  0  0 0 0 0 0  32 0  0  0  0  0  0  0  0 0 0 0  0  0  0  0  0  0  0  0  0 0  0 0 0  0  0  0  0  0 0 0 0  0  0  16 0  16 0  0  0  0  0  0  0  0  0 0 0 0 0 0 0 
6 0  0  0  0  0  0  0 0 0 0 0 0 0 0  0  0  0  0  0  0  1 2 2 2 3  31 0  1  2  3  0  0  0  0 0 0 0  0  0  0  0  0  0  0  0  0 0  0 0 0  0  0  0  0  0 0 0 0  0  0  0  0  0  0  0  0  0  0  0  0  0  0 0 0 0 0 0 0 
6 0  0  0  0  0  0  0 0 0 0 0 0 0 0  0  0  0  0  0  0  4 5 5 5 17 2  2 18  5  6  0  0  0  0 0 0 0  0  0  0  0  0  0  0  0  0 0  0 0 0  0  0  0  0  0 0 0 0  0  0  0  0  0  0  0  0  0  0  0  0  0  0 0 0 0 0 0 0 
6 0  0  0  0  0  0  0 0 0 0 0 0 0 0  0  0  0  0  0  0  7 8 8 8 8  8  8  8  8  9  0 10 11 12 0 0 0  0  0  0  0  0  0  0  0  0 0  0 0 0  0  0  0  0  0 0 0 0  0  0  0  0  0  0  0  0  0  0  0  0  0  0 0 0 0 0 0 0 
6 0  67 66 66 69 0  0 0 0 0 0 0 0 0  0  0  0  0  0  0  0 0 0 0 0  0  0  0  0  0  0  0  0  0 0 0 0  0  0  0  0  0  0  0  0  0 0  0 0 0  0  0  0  0  0 0 0 0  0  16 0  16 0  16 0  0  0  0  0  0  0  0 0 0 0 0 0 0 
17 2 3  65 65 70 0  0 0 0 0 0 0 0 0  0  0  0  0  0  0  0 0 0 0 0  0  0  0  0  0  0  0  0  0 0 0 67 66 69 0  0  0  0  0  0  0 0  0 0 0  0  0  0  0  0 0 0 0  0  0  0  0  0  0  0  0  0  0  0  0  0  0 0 0 0 0 0 0 
5 19 0  0  0  0  0  0 0 0 0 0 0 0 0  0  0  0  0  0  0  0 0 0 0 0  0  0  0  0  0  0  0  0  0 0 1 3  65 70 0  0  0  0  0  0  0 0  0 0 0  0  0  0  0  0 0 0 0  0  0  0  0  0  0  0  0  0  0  0  0  0  0 0 0 0 0 0 0 
25 0 0  0  0  0  0  0 0 0 0 0 0 0 0  0  0  0  0  0  0  0 0 0 0 0  0  0  0  0  0  0  0  0  0 0 7 9  0  0  0  0  0  0  0  0  0 0  0 0 0  0  0  0  0  0 0 0 0  0  0  0  0  0  0  0  0  0  0  0  0  0  0 0 0 0 0 0 0 
6 0  0  0  0  0  0  0 0 0 0 0 0 0 0  0  0  0  0  0  0  0 0 0 0 0  0  0  0  0  0  0  0  0  0 0 0 0  0  0  0  67 66 66 68 0  0 0  0 0 0  0  0  0  0  0 0 0 0  0  0  0  0  0  0  0  0  0  0  0  0  0  0 0 0 0 0 0 0
6 0  0  0  0  0  0  0 0 0 0 0 0 0 0  0  67 66 66 68 0  0 0 0 0 0  0  0  0  0  0  0  0  0  0 0 0 0  0  0  10 11 11 11 11 12 0 0  0 0 0  0  16 0  0  0 0 0 0  16 0  16 0  16 0  16 0  0  0  0  0  0  0 0 0 0 0 0 0
6 0  0  0  0  0  0  0 0 0 0 0 0 0 0  10 11 11 11 11 12 0 0 0 0 0  0  0  0  0  0  0  0  0  0 0 0 71 66 69 0  0  0  0  0  0  0 0  0 0 0  0  0  0  0  0 0 0 0  0  0  0  0  0  0  0  0  0  0  0  0  0  0 0 0 0 0 0 0
6 0  0  0  0  0  0  0 0 0 0 0 0 0 0  0  0  0  0  0  0  0 0 0 0 0  0  0  0  0  0  0  0  0  0 0 0 72 65 70 0  0  0  0  0  0  0 0  0 0 0  0  0  0  0  0 0 0 0  0  0  0  0  0  0  0  0  0  0  0  0  0  0 0 0 0 0 0 0
6 0  0  0  0  0  0  0 0 0 0 0 0 0 0  0  0  0  0  0  0  0 0 0 0 67 66 66 66 66 66 66 66 68 0 0 0 0  0  0  0  0  0  0  0  0  0 0  0 0 0  0  0  0  0  0 0 0 0  0  0  0  0  0  0  0  0  0  0  0  0  0  0 0 0 0 0 0 0
6 0  0  0  0  0  0  0 0 0 0 0 0 0 0  0  0  0  0  0  0  0 0 0 0 10 11 11 11 11 11 11 11 12 0 0 0 0  0  0  0  0  0  0  0  0  0 0  0 0 0  0  0  0  0  0 0 0 0  0  0  0  0  0  0  0  0  0  0  0  0  0  0 0 0 0 0 0 0
6 0  0  0  0  0  0  0 0 0 0 0 0 0 0  0  0  0  0  0  0  0 0 0 0 0  0  0  0  0  0  0  0  0  0 0 0 0  0  0  0  0  0  0  0  0  0 0  0 0 0  0  0  0  0  0 0 0 0  0  0  0  0  0  0  0  0  0  0  0  0  0  0 0 0 0 0 0 0
6 0  0  0  0  0  0  0 0 0 0 0 0 0 29 0  0  0  0  0  0  0 0 0 0 0  0  0  0  0  0  0  0  0  0 0 0 67 66 66 66 66 66 68 0  0  0 0  0 0 0  0  0  0  0  0 0 0 0  0  0  0  0  0  0  0  0  0  0  0  0  0  0 0 0 0 0 0 0
6 0  0  0  0  0  0  1 2 2 2 2 2 2 3  0  0  0  0  0  0  0 0 0 0 0  0  0  0  0  0  0  0  0  0 0 0 10 11 11 11 11 11 12 0  0  0 0  0 0 0  0  0  0  0  0 0 0 0  0  0  0  0  0  0  0  0  0  0  0  0  0  0 0 0 0 0 0 0
6 0  0  0  0  0  0  4 5 5 5 5 5 5 6  0  0  0  0  0  0  0 0 0 0 0  0  0  0  0  0  0  0  0  0 0 0 0  0  0  0  0  0  0  0  0  0 0  0 0 0  0  0  0  0  0 0 0 0  0  0  0  0  0  0  0  0  0  0  0  0  0  0 0 0 0 0 0 0
6 0  0  0  0  0  0  7 8 8 8 8 8 8 9  0  0  0  0  0  0  0 0 0 0 0  0  0  0  0  0  0  0  0  0 0 0 0  0  0  0  0  0  0  0  0  0 0 0 67 66 66 69 0  0  1 2 2 2  2  2  3  0  0  0  0  0  0  0  0  0  0  0 0 0 0 0 0 0 
6 0  0  0  0  0  0  0 0 0 0 0 0 0 0  0  0  0  0  0  0  0 0 0 0 0  0  0  0  0  0  0  0  0  0 0 0 0  0  0  0  0  0  0  0  0  0 1  2 3 65 65 70 0  0  4 5 5 5  5  5  9  0  0  0  0  0  0  0  0  0  0  0 0 0 0 0 0 0 
6 0  0  0  0  0  0  0 0 0 0 0 0 0 0  0  0  0  0  0  0  0 0 0 0 0  0  0  0  0  0  0  0  0  0 0 0 0  0  0  0  0  0  0  0  0  0 4  5 6  0 0  0  0  0  4 5 5 5  5  19 0  0  0  0  0  0  0  0  0  0  0  0 0 0 0 0 0 0 
6 47 45 45 45 45 50 0 0 0 0 0 0 0 0  0  0  0  0  0  0  0 0 0 0 0  0  0  0  0  0  0  0  0  0 0 0 0  0  0  0  0  0  0  0  0  0 4  5 6  0 0  0  0  0  4 5 5 5  25 0  0  0  0  0  0  0  0  0  67 66 69 0 0 0 0 0 0 0 
6 48 43 43 44 43 51 0 0 0 0 0 0 0 0  0  0  0  0  0  0  0 0 0 0 0  0  0  0  0  0  0  0  0  0 0 0 0  0  0  0  0  0  0  0  0  0 4  5 6  0 0  0  0  0  7 8 8 8  9  0  0  10 11 11 11 11 11 11 12 65 70 0 0 0 0 0 0 0 
6 48 43 43 43 43 51 0 0 0 0 0 0 0 0  0  0  0  0  0  0  0 0 0 0 0  0  0  0  0  0  0  0  0  0 0 0 0  0  0  0  0  0  0  0  0  0 4  5 6  0 0  0  0  0  0 0 0 0  0  0  0  0  0  0  0  0  0  0  0  0  0  0 0 0 0 0 0 0 
6 49 46 41 46 46 52 0 0 0 0 0 0 0 0  0  0  0  0  0  0  0 0 0 0 0  0  0  0  0  0  0  0  0  0 0 0 0  0  0  0  0  0  0  0  0  0 4 23 6  0 0  0  0  0  0 0 0 0  0  0  0  0  0  0  0  0  0  0  0  0  0  0 0 0 0 0 0 0 
6 0  0  34 62 53 38 0 0 0 0 0 0 0 0  0  0  0  0  0  0  0 0 0 0 0  0  0  0  0  0  0  0  0  0 0 0 0  0  0  0  0  0  0  0  0  0 27 0 28 0 0  0  0  0  0 0 0 0  0  0  0  0  0  0  0  0  0  0  0  0  0  0 0 0 0 0 0 0 
6 0  37 33 0  58 0  0 0 0 0 0 0 0 0  0  67 66 66 66 68 0 0 0 0 0  67 66 66 66 66 66 66 68 0 0 0 0  0  0  0  0  0  0  0  0  0 14 0 15 0 0  0  0  0  0 0 0 0  0  0  0  0  0  0  0  0  0  0  0  0  0  0 0 0 0 0 0 0 
6 0  0  32 0  0  0  0 0 0 0 0 0 0 1  2  3  65 65 65 1  2 2 2 2 2  3  65 65 65 16 65 65 1  2 2 2 2  2  3  66 66 66 66 66 68 0 14 0 0  0 0  0  0  0  0 0 0 0  0  0  0  0  0  0  0  0  0  0  0  0  0  1 2 2 2 2 2 3 
6 0  0  32 0  0  0  0 0 0 0 0 0 0 4  5  6  0  0  0  4  5 5 5 5 5  6  0  0  0  0  0  0  7  5 5 5 5  5  6  65 65 65 65 65 13 0 14 0 0  0 0  0  0  0  0 0 0 0  0  67 66 69 0  0  0  0  0  0  0  0  0  7 8 8 8 8 8 9 
6 0  0  31 0  0  0  0 0 0 0 0 0 0 4  5  6  0  0  0  4  5 5 5 5 5  6  0  0  0  0  0  0  0  20 5 5 5 5  6  0  0  0  0  0  14 0 15 0 0  0 0  29 0  0  0 0 0 10 11 12 65 70 0  0  0  0 42  0  0  0  0  0 0 0 0 0 0 0 
17 2 2  2  2  2  3  0 0 0 1 2 2 2 18 5  6  0  0  0  4  5 5 5 5 5  6  0  0  0  0  0  0  0  0 26 5 5 5  6  0  0  0  0  0  14 0 0  0 1  2 11 11 11 12 0 0 0 0  0  0  0  0  0  0  0 37 33  0  0  0  0  0 0 0 0 0 0 0 
5 5  5  5  5  5  6  0 0 0 4 5 5 5 5  5  6  0  0  0  4  5 5 5 5 5  6  0  0  0  0  0  0  0  0  7 8 8 8  9  0  0  0  0  0  14 0 0  0 4 19 0  0  0  0  0 0 0 0  0  0  0  0  0  0  0  0 32  0  0  0  0  0 0 0 0 0 0 0
5 5  5  5  5  5  17 2 2 2 18 5 5 5 5 5  6  0  0  0  4  5 5 5 5 5  6  0  0  0  0  0  0  0  0 0 0 0  0  0  0  0  0  0  0  14 0 0  0 27 0 0  0  0  0  0 0 0 0  0  0  0  0 71 66 68  0 31  0  0  0  0  0 0 0 0 0 0 0
5 5  5  5  5  5  5  5 5 5 5 5 5 5 5  5  6  0  0  0  4  5 5 5 5 5  6  0  0  0  0  0  0  0  0 0 0 0  0  0  0  0  0  0  0  14 0 0  0 14 0 0  0  0  0  0 0 0 0  0  0  0  0 72 65  1  2 2   2  3  0  0  0 0 0 0 0 0 0 
5 5  5  5  5  5  5  5 5 5 5 5 5 5 5  5  6  0  0  0  4  5 5 5 5 5  6  0  0  0  0  0  0  0  0 0 0 0  0  0  0  0  0  0  0  21 2 2  2 22 0 0  0  0  0  0 0 0 0  0  0  0  0  0  0  4  5 5   5  6  0  0  0 0 0 0 0 0 0 
5 5  5  5  5  5  5  5 5 5 5 5 5 5 5  5  6  0  0  0  4  5 5 5 5 5  6  0  0  0  0  0  0  0  0 0 0 0  0  0  0  0  0  0  0  4  5 5  5 6  0 0  0  0  0  0 0 0 0  0  0  0  0  0  0  4  5 5   5  6  0  0  0 0 0 0 0 0 0 
0 0 0 0 0 0 0 0 0 0 0 0 0 0 0 0 0 0 0 0 0 0 0 0 0 0 0 0 0 0 0 0 0 0 0 0 0 0 0 0 0 0 0 0 0 0